1111111111111
1000100000101
1011111011101
1000000000001
1110101110111
1000101010101
1011101010101
1000000010001
1111111111111
