111111111
100000001
111110101
101000101
101010111
100010001
111111111
